#########
####.####
#.......#
#..#...g#
##......#
#...*.###
#.....###
###....p#
..##....#
...######
