#########
#########
#...g...#
#.......#
#....#p.#
#.......#
#....#..#
##....#.#
#########
