###########
#.........#
####......#
#g..W..p..#
####...#..#
#..#***.#.#
#..#......#
#........##
##...##..##
###########
