
#######
#g.#..#
#.....#
#.....#
#.#.p.#
###...#
#######

