
##############.
#...###......#.
#.#...#....####
#.#...w..**...#
#.....#.......#
#####w#......##
.##..........#.
.##..........#.
###.*........#.
.###.g....p..#.
.#.##........#.
##..##.......#.
.#############.
