#############
#......#....#
#...........#
#........p..#
##....w.....#
#..**wgw....#
#.....w....##
#.....*.....#
#.....*.....#
#...........#
#....#......#
#############